SO         textures/ea.xpm

F 87,206,235
C 22,139,22

NO textures/ea.xpm
WE textures/ea.xpm
EA textures/ea.xpm


        111111111111111111111111111
        1S000000001100000000000000111
        101100000111000000000000111
        1001000000000000000000001
111111111011000001110000000000001
100000000011000001110111111111111
11110111111111011100000010001
11110111111111111101010010001
110000001101    11100000010001
100000000001111101100000010001
1000000000000000011010100010001
110000011101010111110111100111
11110111 1110101 101111010001
11111111 1111111 111111111111