SO         textures/ea.xpm

F 87,206,235
C 22,139,22


NO textures/ea.xpm
WE textures/ea.xpm
EA textures/ea.xpm



111111111111111111111111111111
100000000000000000000000000001
100000000000000000000000000001
100000000000000000000000000001
100000000000000000000000000001
100000000000111111000000000001
100000000000100001000000000001
100000000000100001000000000001
100000000000111011000000000001
100000000000000000000000000001
10000000000000N000000000000001
100000000000000000000000000001
100000000000000000000000000001
111111111111111111111111111111
