SO          ../path/south


F 254,100,0
C 225,30,0

NO ../path/north
WE ../path/west
EA ../path/east


        111111111111111111111111111
        10000000001100000000000000111
        101100000111000000000000111
        1001000000000000000000001
111111111011000001110000000000001
100000000011000001110111111111111
11110111111111011100000010001
11110111111111111101010010001
110000001101    11100000010001
100000000001111101100000010001
1000000000000N00011010100010001
110000011101010111110111100111
11110111 1110101 101111010001
11111111 1111111 111111111111