SO         textures/so.xpm

F 59,178,237
C 225,214,255


NO textures/no.xpm
WE textures/we.xpm

EA textures/ea.xpm



111111111111111111111111111111
100000000000000000000000000001
100000000000000000000000000001
100000000000000000000000000001
100000000000000000000000000111
111100000000111111000000000001
100000000000100001000000000001
100000000000100001000000000001
100000000000111011000000000001
100000000000000000000000000001
1000000000000010000000N0000001
100001000000000000000000000011
100000000000000000000000000101
111111111111111111111111111 111            